[
  {
    "type": "mapgen",
    "method": "json",
    "nested_mapgen_id": "24x24_cobbled_road_end",
    "object": {
      "mapgensize": [ 24, 24 ],
      "rows": [
        "                        ",
        "                        ",
        "                        ",
        "                        ",
        "        *||||||*        ",
        "       *||||||||*       ",
        "      *||||||||||*      ",
        "     *||||||||||||*     ",
        "     *||||||||||||*     ",
        "     *||||||||||||*     ",
        "     *||||||||||||*     ",
        "     *||||||||||||*     ",
        "     *||||||||||||*     ",
        "     *||||||||||||*     ",
        "     *||||||||||||*     ",
        "     *||||||||||||*     ",
        "     *||||||||||||*     ",
        "     *||||||||||||*     ",
        "     *||||||||||||*     ",
        "     *||||||||||||*     ",
        "     *||||||||||||*     ",
        "     *||||||||||||*     ",
        "     *||||||||||||*     ",
        "     *||||||||||||*     "
      ],
      "flags": [ "ERASE_ALL_BEFORE_PLACING_TERRAIN" ],
      "palettes": [ "cobbled_road_palette" ]
    }
  },
  {
    "type": "mapgen",
    "method": "json",
    "nested_mapgen_id": "24x24_cobbled_road_straight",
    "object": {
      "mapgensize": [ 24, 24 ],
      "rows": [
        "     *||||||||||||*     ",
        "     *||||||||||||*     ",
        "     *||||||||||||*     ",
        "     *||||||||||||*     ",
        "     *||||||||||||*     ",
        "     *||||||||||||*     ",
        "     *||||||||||||*     ",
        "     *||||||||||||*     ",
        "     *||||||||||||*     ",
        "     *||||||||||||*     ",
        "     *||||||||||||*     ",
        "     *||||||||||||*     ",
        "     *||||||||||||*     ",
        "     *||||||||||||*     ",
        "     *||||||||||||*     ",
        "     *||||||||||||*     ",
        "     *||||||||||||*     ",
        "     *||||||||||||*     ",
        "     *||||||||||||*     ",
        "     *||||||||||||*     ",
        "     *||||||||||||*     ",
        "     *||||||||||||*     ",
        "     *||||||||||||*     ",
        "     *||||||||||||*     "
      ],
      "flags": [ "ERASE_ALL_BEFORE_PLACING_TERRAIN" ],
      "palettes": [ "cobbled_road_palette" ]
    }
  },
  {
    "type": "mapgen",
    "method": "json",
    "nested_mapgen_id": "24x24_cobbled_road_curved",
    "object": {
      "mapgensize": [ 24, 24 ],
      "rows": [
        "                        ",
        "                        ",
        "                        ",
        "                        ",
        "                        ",
        "                       *",
        "                      *|",
        "                     *||",
        "                    *|||",
        "                   *||||",
        "                  *|||||",
        "                 *||||||",
        "                *|||||||",
        "               *||||||||",
        "              *|||||||||",
        "             *||||||||||",
        "            *|||||||||||",
        "           *||||||||||||",
        "         *||||||||||||**",
        "       *||||||||||||*   ",
        "     *||||||||||||*     ",
        "     *||||||||||||*     ",
        "     *||||||||||||*     ",
        "     *||||||||||||*     "
      ],
      "flags": [ "ERASE_ALL_BEFORE_PLACING_TERRAIN" ],
      "palettes": [ "cobbled_road_palette" ]
    }
  },
  {
    "type": "mapgen",
    "method": "json",
    "nested_mapgen_id": "24x24_cobbled_road_tee",
    "object": {
      "mapgensize": [ 24, 24 ],
      "rows": [
        "                        ",
        "                        ",
        "                        ",
        "                        ",
        "                        ",
        "************************",
        "||||||||||||||||||||||||",
        "||||||||||||||||||||||||",
        "||||||||||||||||||||||||",
        "||||||||||||||||||||||||",
        "||||||||||||||||||||||||",
        "||||||||||||||||||||||||",
        "||||||||||||||||||||||||",
        "||||||||||||||||||||||||",
        "||||||||||||||||||||||||",
        "||||||||||||||||||||||||",
        "||||||||||||||||||||||||",
        "||||||||||||||||||||||||",
        "******||||||||||||******",
        "     *||||||||||||*     ",
        "     *||||||||||||*     ",
        "     *||||||||||||*     ",
        "     *||||||||||||*     ",
        "     *||||||||||||*     "
      ],
      "flags": [ "ERASE_ALL_BEFORE_PLACING_TERRAIN" ],
      "palettes": [ "cobbled_road_palette" ]
    }
  },
  {
    "type": "mapgen",
    "method": "json",
    "nested_mapgen_id": "24x24_cobbled_road_four_way",
    "object": {
      "mapgensize": [ 24, 24 ],
      "rows": [
        "     *||||||||||||*     ",
        "     *||||||||||||*     ",
        "     *||||||||||||*     ",
        "     *||||||||||||*     ",
        "     *||||||||||||*     ",
        "******||||||||||||******",
        "||||||||||||||||||||||||",
        "|||||||0||||||||||||||||",
        "||||||||||||||||||||||||",
        "||||||||||||||||||||||||",
        "||||||||||||||||||||||||",
        "||||||||||||||||||||||||",
        "||||||||||||||||||||||||",
        "||||||||||||||||||||||||",
        "||||||||||||||||||||||||",
        "||||||||||||||||||||||||",
        "||||||||||||||||||||||||",
        "||||||||||||||||||||||||",
        "******||||||||||||******",
        "     *||||||||||||*     ",
        "     *||||||||||||*     ",
        "     *||||||||||||*     ",
        "     *||||||||||||*     ",
        "     *||||||||||||*     "
      ],
      "flags": [ "ERASE_ALL_BEFORE_PLACING_TERRAIN" ],
      "palettes": [ "cobbled_road_palette" ],
      "nested": { "0": { "chunks": [ [ "null", 150 ], [ "vegetation_rotary_10x10", 150 ] ] } }
    }
  }
]
