[
  {
    "type": "mapgen",
    "om_terrain": "general_store01g_normal",
    "//": "Ground floor for general store layout 01: normal setup: no abandonment, no barricading. Pristine condition with a decent amount of items left, though with chances for low stores as well.",
    "weight": 250,
    "method": "json",
    "object": {
      "fill_ter": "t_floor",
      "rows": [
        "..########$__$#########.",
        "..#||||||#____#|||||||#.",
        "..#||||||#____#|||||||#.",
        "..#||||||##oo##|||||||#.",
        "..#||||||#||||#|||||||#.",
        "..#||||||*||||*|||||||#.",
        "..#||||||#||||#|||||||#.",
        "..#||||||#||||#|||||||#.",
        "..#||||||#||||#|||||||#.",
        "..#||||||#||||#|||||||#.",
        "..########aaba#|||||||#.",
        "..#||||||#||||#|||||||#.",
        "..#||||||#||||#|||||||#.",
        "..#||||||##o#########|#.",
        "..#||||||#|||#||#.......",
        "..#||||||#|||i|$#.......",
        "..#||||||i|||#|>#.......",
        "..#||||||#|||####.......",
        "..#||||||#|||#..........",
        "..#########o##..........",
        "........................",
        "........................",
        "........................",
        "........................"
      ],
      "palettes": [ "cottage_palette_common" ]
    }
  }
]
