[
  {
    "type": "mapgen",
    "om_terrain": "general_store01g_normal",
    "//": "Ground floor for general store layout 01: normal setup: no abandonment, no barricading. Pristine condition with a decent amount of items left, though with chances for low stores as well.",
    "weight": 250,
    "method": "json",
    "object": {
      "fill_ter": "t_floor",
      "rows": [
        "..##t##t##$__$##t###t##.",
        "..#||||||#____#|||||||#.",
        "..#||||||#____#|||||||#.",
        "..#||||||##oo##|||||||#.",
        "..#||||||#||||#|||||||#.",
        "..#||||||*||||*|||||||#.",
        "..#||||||#||||#|||||||#.",
        "..#||||||#||||#|||||||#.",
        "..#||||||#||||#|||||||#.",
        "..#||||||#||||#####|||#.",
        "..########aaba#||f#|||#.",
        "..#||||||#||||i|c|#|||#.",
        "..#||||||#||||#edd#|||#.",
        "..#||||||##o###########.",
        "..#||||||#||#||#........",
        "..#||||||i||i|$#........",
        "..#||||||#||#|>#........",
        "..########o#####........",
        "........................",
        "........................",
        "........................",
        "........................",
        "........................",
        "........................"
      ],
      "palettes": [ "general_store_palette_common" ]
    }
  },
  {
    "type": "mapgen",
    "om_terrain": "general_store01f2_normal",
    "//": "2nd floor apartment for general store layout 01: normal setup: no abandonment, no barricading. Pristine condition with missing, dead, or maddened occupants.",
    "weight": 250,
    "method": "json",
    "object": {
      "fill_ter": "t_open_air",
      "rows": [
        "  ##################### ",
        "  #|||||||||||||||||||# ",
        "  #|0|||||||||||||||||# ",
        "  #|||||||||||||||||||# ",
        "  #|||||||||||||||||||# ",
        "  #|||||||||||||||||||# ",
        "  #|||||||||||||||||||# ",
        "  #|||||||||||||||||||# ",
        "  #########|||||||||||# ",
        "  #|||||||#|||||||||||# ",
        "  #|||||||#|||||||||||# ",
        "  #|||||||#|||||||||||# ",
        "  #|||||||i|||||||||||# ",
        "  #|||||||#|########### ",
        "  #|||||||#|#|!#        ",
        "  #|||||||#|i|$#        ",
        "  #|||||||#|#|<#        ",
        "  ##############        ",
        "                        ",
        "                        ",
        "                        ",
        "                        ",
        "                        ",
        "                        "
      ],
      "palettes": [ "cottage_palette_common" ],
      "nested": {
        "0": {
          "chunks": [
            [ "cottage_livingroom_centre5x5_1", 100 ],
            [ "cottage_livingroom_centre5x5_2", 100 ],
            [ "cottage_livingroom_centre5x5_3", 100 ],
            [ "cottage_livingroom_centre5x5_4", 100 ],
            [ "cottage_livingroom_centre5x5_5", 100 ],
            [ "cottage_livingroom_centre5x5_6", 100 ]
          ]
        }
      }
    }
  },
  {
    "type": "mapgen",
    "om_terrain": "general_store01r",
    "//": "roof for general store layout 01, used across all variants of general store 01.",
    "weight": 250,
    "method": "json",
    "object": {
      "fill_ter": "t_open_air",
      "rows": [
        "  +++++++++++++++++++++ ",
        "  +++++++++++++++++++++ ",
        "  +++++++++++++++++++++ ",
        "  +++++++++++++++++++++ ",
        "  +++++++++++++++++++++ ",
        "  +++++++++++++++++++++ ",
        "  +++++++++++++++++++++ ",
        "  +++++++++++++++++++++ ",
        "  +++++++++++++++++++++ ",
        "  +++++++++++++++++++++ ",
        "  +++++++++++++++++++++ ",
        "  +++++++++++++++++++++ ",
        "  +++++++++++++++++++++ ",
        "  +++++++++++++++++++++ ",
        "  ++++++++++++++        ",
        "  ++++++++++++++        ",
        "  ++++++++++++++        ",
        "  ++++++++++++++        ",
        "                        ",
        "                        ",
        "                        ",
        "                        ",
        "                        ",
        "                        "
      ],
      "palettes": [ "cottage_palette_common" ]
    }
  }
]
