[
  {
    "type": "mapgen",
    "om_terrain": "cottage01g_normal",
    "//": "Ground floor for cottage layout 01: normal setup: no abandonment, no barricading. Pristine layout with missing, maddened, or dead occupants.",
    "weight": 250,
    "method": "json",
    "object": {
      "fill_ter": "t_floor",
      "rows": [
        "..........##o##.........",
        "..........#b|a#.........",
        ".##########|||#.........",
        ".#c||c######i##########.",
        ".#|||||||||#|#ddd#hhjh#.",
        ".#|||||||||#|#|e|#|||h#.",
        ".#|||||||||#|#|||#|||g#.",
        ".#|||||||||#|##i##|||g#.",
        ".#|||||||||i||||||||||#.",
        ".#|||||||||#|##i##|ee|#.",
        ".#|||||||||#|#b||#|ff|#.",
        ".#|||||||||#|#|||#|ee|#.",
        ".#|||||||||#|#>$<#||||#.",
        ".###########i##########.",
        "........................",
        "........................",
        "........................",
        "........................",
        "........................",
        "........................",
        "........................",
        "........................",
        "........................",
        "........................"
      ],
      "palettes": [ "cottage_palette_common" ]
    }
  },
  {
    "type": "mapgen",
    "om_terrain": "cottage01f2_normal",
    "//": "2nd floor for cottage layout 01: normal setup: no abandonment, no barricading. Pristine layout with missing, maddened, or dead occupants.",
    "weight": 250,
    "method": "json",
    "object": {
      "fill_ter": "t_open_air",
      "rows": [
        "          +++++         ",
        "          +++++         ",
        " ++++++++++++++         ",
        " ++++++++++++++++++++++ ",
        " ++++++++++++++++++++++ ",
        " +++++################+ ",
        " +++++#ddn||||#|#nmmn#+ ",
        " +++++#dp^^^||i|i|^^|#+ ",
        " +++++#n|^^^||#|#|^^|#+ ",
        " +++++#m|^^^||#|#||||#+ ",
        " +++++#m|||||##i##|||#+ ",
        " +++++#|bqqb|#|||#l|l#+ ",
        " +++++#|bqqb|#<$!#kbk#+ ",
        " +++++################+ ",
        "                        ",
        "                        ",
        "                        ",
        "                        ",
        "                        ",
        "                        ",
        "                        ",
        "                        ",
        "                        ",
        "                        "
      ],
      "palettes": [ "cottage_palette_common" ]
    }
  },
  {
    "type": "mapgen",
    "om_terrain": "cottage01r",
    "//": "roof for cottage layout 01, used across all variants of cottage 01.",
    "weight": 250,
    "method": "json",
    "object": {
      "fill_ter": "t_open_air",
      "rows": [
        "                        ",
        "                        ",
        "                        ",
        "                        ",
        "                        ",
        "      ++++++++++++++++  ",
        "      ++++++++++++++++  ",
        "      ++++++++++++++++  ",
        "      ++++++++++++++++  ",
        "      ++++++++++++++++  ",
        "      ++++++++++++++++  ",
        "      ++++++++++++++++  ",
        "      ++++++++++++++++  ",
        "      ++++++++++++++++  ",
        "                        ",
        "                        ",
        "                        ",
        "                        ",
        "                        ",
        "                        ",
        "                        ",
        "                        ",
        "                        ",
        "                        "
      ],
      "palettes": [ "cottage_palette_common" ]
    }
  }
]
