[
  {
    "type": "mapgen",
    "om_terrain": "cottage01g_normal",
    "//": "Ground floor for cottage layout 01: normal setup: no abandonment, no barricading. Pristine layout with missing, maddened, or dead occupants.",
    "weight": 250,
    "method": "json",
    "object": {
      "fill_ter": "t_floor",
      "rows": [
        "..........##o##.........",
        "..........#|||#.........",
        ".##########|||#.........",
        ".###########i##########.",
        ".#|||||||||#|#|||#||||#.",
        ".#|||||||||#|i|||#||||#.",
        ".#|||||||||#|#|||#||||#.",
        ".#|||||||||#|#####||||#.",
        ".#|||||||||i||||||||||#.",
        ".#|||||||||#|##i##||||#.",
        ".#|||||||||#|#|||#||||#.",
        ".#|||||||||#|#|||#||||#.",
        ".#|||||||||#|#|||#||||#.",
        ".######################.",
        "........................",
        "........................",
        "........................",
        "........................",
        "........................",
        "........................",
        "........................",
        "........................",
        "........................",
        "........................"
      ],
      "palettes": [ "cottage_palette_common" ]
    }
  }
]
