[
  {
    "type": "mapgen",
    "om_terrain": "cottage01g_normal",
    "//": "Ground floor for cottage layout 01: normal setup: no abandonment, no barricading. Pristine layout with missing, maddened, or dead occupants.",
    "weight": 250,
    "method": "json",
    "object": {
      "fill_ter": "t_floor",
      "rows": [
        "..........##o##.........",
        "..........#b|a#.........",
        ".##########|||#.........",
        ".#c||c######i##########.",
        ".#|||||||||#|#ddd#hhjh#.",
        ".#|||||||||#|#|e|#|||h#.",
        ".#||0||||||#|#|||#|||g#.",
        ".#|||||||||#|##i##|||g#.",
        ".#|||||||||i||||||||||#.",
        ".#|||||||||#|##i##|ee|#.",
        ".#|||||||||#|#b||#|ff|#.",
        ".#c||||||||#|#|||#|ee|#.",
        ".#rc|||||||#|#>$<#||||#.",
        ".###########o##########.",
        ".'....................'.",
        ".'....................'.",
        ".'....................'.",
        ".'....................'.",
        ".'....................'.",
        ".'....................'.",
        ".'.wyw................'.",
        ".'.w.w................'.",
        ".'.www................'.",
        ".''''''''''''''''''''''."
      ],
      "palettes": [ "cottage_palette_common" ],
      "place_nested": [
        { "chunks": [ [ "null", 25 ], [ "cottage_gun_safe2x2", 25 ], [ "cottage_bookcase_corner2x2", 50 ] ], "x": 9, "y": 4 }
      ],
      "nested": {
        "0": {
          "chunks": [
            [ "cottage_livingroom_centre5x5_1", 100 ],
            [ "cottage_livingroom_centre5x5_2", 100 ],
            [ "cottage_livingroom_centre5x5_3", 100 ],
            [ "cottage_livingroom_centre5x5_4", 100 ],
            [ "cottage_livingroom_centre5x5_5", 100 ],
            [ "cottage_livingroom_centre5x5_6", 100 ]
          ]
        }
      }
    }
  },
  {
    "type": "mapgen",
    "om_terrain": "cottage01f2_normal",
    "//": "2nd floor for cottage layout 01: normal setup: no abandonment, no barricading. Pristine layout with missing, maddened, or dead occupants.",
    "weight": 250,
    "method": "json",
    "object": {
      "fill_ter": "t_open_air",
      "rows": [
        "          +++++         ",
        "          +++++         ",
        " ++++++++++++++         ",
        " ++++++++++++++++++++++ ",
        " ++++++++++++++++++++++ ",
        " +++++################+ ",
        " +++++#ddn||||#|#nmmn#+ ",
        " +++++#dp^^^||i|i||||#+ ",
        " +++++#n|^^^||#|#|^^|#+ ",
        " +++++#m|^^^||#|#|^^|#+ ",
        " +++++#m|||||##i##|||#+ ",
        " +++++#||qq||#|||#l|l#+ ",
        " +v+++#|bqqb|#<$!#kbk#+ ",
        " +++++################+ ",
        "                        ",
        "                        ",
        "                        ",
        "                        ",
        "                        ",
        "                        ",
        "   ***                  ",
        "   ***                  ",
        "   ***                  ",
        "                        "
      ],
      "palettes": [ "cottage_palette_common" ],
      "place_nested": [ { "chunks": [ [ "null", 25 ], [ "cottage_gun_safe2x2", 25 ], [ "cottage_bookcase_sbs2x2", 50 ] ], "x": 12, "y": 6 } ]
    }
  },
  {
    "type": "mapgen",
    "om_terrain": "cottage01r",
    "//": "roof for cottage layout 01, used across all variants of cottage 01.",
    "weight": 250,
    "method": "json",
    "object": {
      "fill_ter": "t_open_air",
      "rows": [
        "                        ",
        "                        ",
        "                        ",
        "                        ",
        "                        ",
        "      ++++++++++++++++  ",
        "      ++++++++++++++++  ",
        "      ++++++++++++++++  ",
        "      ++++++++++++++++  ",
        "      ++++++++++++++++  ",
        "      ++++++++++++++++  ",
        "      ++++++++++++++++  ",
        "      ++++++++++++++++  ",
        "      ++++++++++++++++  ",
        "                        ",
        "                        ",
        "                        ",
        "                        ",
        "                        ",
        "                        ",
        "                        ",
        "                        ",
        "                        ",
        "                        "
      ],
      "palettes": [ "cottage_palette_common" ]
    }
  }
]
